08 05 02
XXXXXXXX
X..J..GX
XMJ...GX
X......X
XXXXXXXX